XXXXXXXXXXXXXXXXXXXX
XGXS.............XPX
XXXX..X.X.X.X.X..X.X
.OXX.XX.X.X.X.X.....
X..X.X..XXX.X.X..XXX
X..X.X.XO...X.X....X
X......X.XXXX....XXX
X.XX.X.X.X....X....X
X..X.X........X.X..X
XXXX.X.XXXXXX.XXXX.X
.....X........X.....
X.XXXX.XXXXXX.X.XXXX
X.X.X...X.X.X.X.X.XX
X.....X............X
XX.X.X.X.X.X.X.X.X.X
XO.................X
X.X.X.X.X.X.X.X.X.XX
X.................OX
XXXXXXXXXXXXXXXXXXXX
                     "labrynth" by RogueNine